x......................
!!!!!!!!!!!!!!!!!!!!!!.
!....................!.
!....................!.
!....................!.
!....................!.
!....................!.
!....................!.
!....................!.
!....................!.
!....................!.
!....................!.
!.S.............D....!.
!%%%%%%%%%%%%%%%%%%%%%y
#demo5?
c6a?
null?
c6b, c6c?